b b b b b b b b b b b b b b b b b b b b
b i e e e e e e e e e e e e e e e e h b
b e b b b b b b b e b b b b b b b b e b
b e e e b b b b b e b b b b b b b b e b
b b b e b b b b b e b b b b b b b b e b
b b b e e e b b b e b b b b b b b b e b
b b b b b e b b b e b b b b b b b b e b
b b b b b e b b b e b b b b b b b b e b
b b b b b e e e b e b b b b b b b b e b
b b b b b b b e b e b b b b b b b b e b
b b b b b b b e e e e e e e e e b b e b
b b b b b b b b b e b b e b b e b b e b
b b b b b b b b b e b b e b b e b b e b
b b b b b b b b b e b b e b b e b b e b
b b b b b b b b b e e e e e e e e e e b
b b b b b b b b b e b b b b b b b b e b
b b b b b b b b b e b b j e e e e e e b
b b b b b b b b b e b b b b b b b b e b
b b b b b b b b b e e e e e e e e e e b
b b b b b b b b b b b b b b b b b b b b
