b b b b b b b b b b b b b b b
b h e e e e e e e e e e e e b
b e b b b b b e b b e b b e b
b e b b b b b e b b e b b e b
b e e e i b b e b b e e e e b
b e b b e b b e b b b b b e b
b e b b e b b e b b b b b e b
b e e e e e e e e e e e e e b
b b b b b b b e b b e b b e b
b b b b b b b e b b e b b e b
b b b b b b b e b b e b b e b
b e e e e e e e e e e e e e b
b e b b b b b e b b e b b e b
b e e e e e e e b b e b b j b
b b b b b b b b b b b b b b b
